



s              s
xx            xx
xx            xx
xx            xx
xx            xx
xx        z   xx
xxxxxxxxxxxxxxxx
  xxxxxxxxxxxxxxx
