


s              s
xxx          xxx
xxx          xxx
xxx          xxx
xxx          xxx
xxx          xxx
xxx       z  xxx
xxxxxxxxxxxxxxxx
  xxxxxxxxxxxxxxx
